#####################
#...........o.......#
#...@...............#
#..............o....#
#...............o...#
#.....o.............#
#####################
